11111111111111111
1C0000C0C000C0001
11001111000111001
1000P0000C00000C1
10001111111000111
1000C000C0C0000C1
10000011000000101
11110001111100111
1C000C0C000C00001
11111011110000111
10000000000111001
10001110111000001
10C00000C0000C0E1
11111111111111111
