1111111111111
1C000C0000011
1100111100C11
101P00E000001
1111111111111
