11111111111111111
1C0000C0C000C0001
10P00000000000001
10C00000C0000C0E1
11111111111111111
