1111111111111
1C0000C0C0001
11P0111100011
10001010100E1
1111111111111
