1111111111111
1C000C0000001
1100111100C01
101P00E000001
1111111111111
