1111111111
1P00000001
1001111001
1C00100001
100001C001
1001111001
1000000001
1001111001
1C0000E001
1111111111
