111111111
100E00001
100C10001
1000100P1
111111111
