1111111111111
10010000000C1
1000011111001
1P0011E000001
1100010111011
1111100001111
1110001111111
1111101111111
1110000011111
1111100101011
1111CCCCCCC11
1111111111111
1111111111111
