111111111111111111111111111111111111111
111111111111111111111111111111111111111
111111111111111111111111111111111111111
1C0000C0C000C00011111111111111111111111
10C00000C0P00C0E11111111111111111111111
111111111111111111111111111111111111111
111111111111111111111111111111111111111
111111111111111111111111111111111111111
111111111111111111111111111111111111111
111111111111111111111111111111111111111
111111111111111111111111111111111111111
111111111111111111111111111111111111111
111111111111111111111111111111111111111
