1111111111111
1001CCC000CC1
1000011111001
1P0000E000001
1111111111111
