1111111111111
100100CCCC0C1
100C011111001
1P0011E000001
1111111111111
