1111111111111
1C000C0000001
1100111110C01
100P1E0000001
1111111111111
